[Non-VR_KeyBindings]
use = Mouse0
increaseThrottle = T
decreaseThrottle = G
increaseBrake = U
decreaseBrake = J
increaseIndependentBrake = I
decreaseIndependentBrake = K
increaseReverser = Y
decreaseReverser = H
increaseDynamicBrake = O
decreaseDynamicBrake = L
increaseHandbrake = P
decreaseHandbrake = Semicolon
increaseCylCock = Comma
decreaseCylCock = M
increaseSand = N
decreaseSand = B
increaseHorn = KeypadPlus
decreaseHorn = KeypadMinus
increaseWiper = Slash
decreaseWiper = Period
increaseHeadlightFront = KeypadDivide
decreaseHeadlightFront = Keypad8
increaseHeadlightRear = KeypadMultiply
decreaseHeadlightRear = Keypad9
alerter = 
pantograph = 
cabOrient = 
bell = 
increaseCabLight = 
decreaseCabLight = 
releaseCyl = 
increaseGearA = LeftBracket
decreaseGearA = Quote
increaseGearB = RightBracket
decreaseGearB = Backslash
openFireDoor = Keypad0
closeFireDoor = KeypadPeriod
openInjector = Keypad4
closeInjector = Keypad1
increaseDraft = Keypad6
decreaseDraft = Keypad3
increaseBlower = Keypad5
decreaseBlower = Keypad2
increaseWaterDump = 
decreaseWaterDump = 
increaseSteamRelease = 
decreaseSteamRelease = 
fireOut = 
shovel = KeypadEnter
steamDump = 
lubricator = 
airPump = 
dynamo = 
lightFire = 
ashPan = 
couple = Insert
uncouple = Delete
couplerSelectionForward = Home
couplerSelectionBack = End
moveLeft = A LeftArrow
moveRight = D RightArrow
moveForward = W UpArrow
moveBack = S DownArrow
crouchModifier = LeftControl
runModifier = LeftShift RightShift
sitToggle = X
jump = Space
leanLeft = Q
leanRight = E
dropItem = V
itemPlacement = R
teleport = F
zoom = Mouse1
alternativeScrollWheelUp = None
alternativeScrollWheelDown = None
mouseLook = LeftAlt
inventoryMouseScrollEnabler = Tab
toggleCameraView = 
photoMode = F5
toggleHUD = F4
contextMenu = E
firstPersonCamera = F1
externalCameraFollow = F2
externalCameraUnfollow = F3
inventorySlot0 = Alpha1
inventorySlot1 = Alpha2
inventorySlot2 = Alpha3
inventorySlot3 = Alpha4
inventorySlot4 = Alpha5
inventorySlot5 = Alpha6
inventorySlot6 = Alpha7
inventorySlot7 = Alpha8
inventorySlot8 = Alpha9
inventorySlot9 = Alpha0
inventorySlot10 = Minus
inventorySlot11 = Equals
inventoryOpen = CapsLock
inventoryClose = CapsLock Escape
recenter = RightControl
toggleTrackingMode = RightAlt
turntableRotateLeft = PageDown
turntableRotateRight = PageUp
starter = 
fuelCutoff = 
starterFuse = 
tractionMotorFuse = 
electricsFuse = 
console = BackQuote
interactionPrimary = Mouse0
interactionSecondary = Mouse1
interactionMiddle = Mouse2